|-----------------------------------------|
|               ,                  ,      |
|                           .            ,|
|     ,     .        ,                 .  |
|         <--------------------->         |
|   .     | O==                 |   .     |
|         |                     |         |
|    ,    | T                   |         |
|         <--------|---|-------->     .   |
|                                         |
|     .                     ,             |
|                ,                 .      |
|-----------------------------------------|